oor                 -> sure
kopje koffie        -> cup coffee
eigenlijk           -> actually
vandaag             -> today
Morgen              -> tomorrow
verjaardag          -> birthday
jarig               -> birthdaying
broer               -> brother
krijg               -> receive
nog                 -> still
bezoek              -> visit
ouders              -> parents
daar                -> there
vakantie            -> holiday
seizoen             -> season
zomer               -> summer
wanneer             -> when
maar                -> but
vertel              -> tell
hoe laat is het?    -> what time is it?
hoe?                -> how
hoe gaat het?       -> how is it going?
moeten              -> muss
les                 -> lesson
weer                -> back

### Homework -> Opdracht 1 / 34
Waar zijn Susy en Edit? Susy en Edit zijn in de kantine
Wat drinkt Susy? Susy drinkt een kopje coffee .
...

### Beschrijven van mensen

jonger      -> younger
ouder       -> older
lang        -> tall/long
klein       -> short/small
kort        -> short
blond       -> blonde
lang        -> long
donker      -> darker

rood        -> red
groen       -> green
blauw       -> blue
geel        -> yellow
oranje      -> orange
paars       -> purple
roze        -> pink
zwart       -> black
wit         -> white
bruin       -> brown

bril -> glasses
ogen -> eyes

Hij heeft..
Hij heeft geen...

### Familieraties

broer   -> brother
zus     -> sister
vader   -> father
moeder  -> mother

Zij is 20 jaar 
Parijs -> Paris

Ik weet het niet -> I don't know
tot Donnerdag!   -> till Thurdsday
